1111111111111111111111111111
1000000000000110000000000001
1011110111110110111110111101
1B111101111101101111101111B1
1011110111110110111110111101
1000000000000000000000000001
1011110110111111110110111101
1011110110111111110110111101
1000000110000110000110000001
1111110111110110111110111111
1111110111110110111110111111
1111110110000000000110111111
1111110110111001110110111111
1111110110100000010110111111
000000000010WXYZ010000000000
1111110110111111110110111111
1111110110111111110110111111
1111110110000000000110111111
1111110111111111111110111111
1111110111111111111110111111
1000000000000110000000000001
1011110111110110111110111101
1011110111110110111110111101
1B001100000000P00000001100B1
1110110110111111110110110111
1110110110111111110110110111
1000000110000110000110000001
1011111111110110111111111101
1011111111110110111111111101
1000000000000000000000000001
1111111111111111111111111111